NO ./assets/mossy.xpm
SO ./assets/greystone.xpm
WE ./assets/eagle.xpm
EA ./assets/blue.xpm

F 128, 128, 128
C 102, 178, 255

        111111111111111111111111
        1000000000110000000000001
        1011000001110000001000001
        100100000000000000000001
111111111011000001110000000000001
100000000011000001110111101111111
11110111111111011100000010001
11110111111111011101010010001
11000000110101011100000010001
10001000000000001100000010001
10000000000000001101010010S001
1100000111010101111101111000011
11110111 1110101 101111010001
11111111 1111111 111111111111
