11111111111111
11111111111111
11P10C*00+0*11
11*1+1!@1C1C11
11C00**0C01E11
11111111111111
11111111111111
