1111111111111111111111111
1++0000000000000000000++1
1+001100000000000001100+1
1001001100+000+0011001001
100101001000+000100101001
10010010*1000001001001001
10010001**100010*10001001
100100010001110*010001001
1000100010000000100010001
1000100100000000010010001
1000101000000000001010001
1000101000000000001010001
1000010000000000000100001
1000010010000000100100001
1000100010000000100010001
1000010MMM00E00MMM0100001
1++0100000000000000010++1
1+000110000000000011000+1
1000000111000001110000001
1000CCC00011011000CCC0001
100000000000P000000000001
1000111100111110111100001
1000100010100000100010001
1000111100111110100010001
1000100100100000100010001
1+001000101111101111000+1
1++00000000+++00000000++1
1111111111111111111111111
