11111111111111111
1EC100000000000C1
10000111100011001
10000C0P1000C1001
11111111111111111
