1111111111111111111111111
1*0**000**0*0*0**000**0*1
10*0000000*000*0001110*01
1*000001100000000100010*1
100000100100000010++01001
100001000010000010+001001
10000100001000010++010001
100001001+1000010+0100001
100000110+011110+01000001
1000000010000000010000001
1000000100000000010000001
1000001000000000001000001
1*000010000000000010000*1
1**0001001000001001000**1
1**0001001000001001000**1
1*000010++00E00++010000*1
1000011100000000011100001
10001000111CCC11100010001
10001000100CCC00100010001
1000011100000000011100001
10000000M0M0M0M0M0M000001
100011111010M010100010001
1000100000100010110110001
100011111010P010101010001
1*000000101000101000100*1
10*0111110*111*0100010*01
1*0**000**0*0*0**000**0*1
1111111111111111111111111
